################################
#..............................#
#.......u....................u.#
#..............................#
#..............................#
################################