############  #####################################
#.....I....#  #.....Q.............................#
#...S......####...................................#
#.@........|..|......................E..........N.d
#..........####...................................#   
#..........#  #......T............................#
#####....#### ###############...###################
    #....#                  #.T.#
    #.T..#                  #####
    ######