##############
#............#
#............#
#d..R...P....#
#.......F....#
#............#
#............#
##############